organization.government.government	/government/government
organization.sports_league	/organization/sports_league
law	/law
person.coach	/person/coach
organization.educational_institution	/organization/educational_institution
organization	/organization
location	/location
person.doctor	/person/doctor
person.athlete	/person/athlete
product	/product
building	/building
time	/time
location.city	/location/city
event	/event
art	/art
location.body_of_water	/body_of_water
person	/person
organization.government_agency	/government_agency
person.artist	/person/artist
person.politician	/person/politician
NORP	/people/ethnicity